#################
#         P     #
#               #
#         # #   #
#         # #   #######
#   O                 #
####       ####       ######
## #        #   X          #
#          ###             #
############################